4 3
******* 
*01010*
*1*1***
*01010*
*1***1*
*010*0*
***1***
*01012*
*******