3 3
******* 
*01010*
*1*1***
*01010*
*1***1*
*010*2*
*******